10 11
9 4
XXXXXXXXXX 
XX...tX..X 
X........X 
XX.......X 
XXXXXXXXXX 
X........X 
X.XX.....X 
X...XX.XXX 
XXX..XXXXX 
XXXX....XX 
XXXXXXXXXX